R 1280   720
S ./textures/pillar.xpm
NO ./textures/north.xpm
SO ./textures/south.xpm      
WE ./textures/west.xpm
EA ./textures/east.xpm
F 220, 100, 0 		
C 225, 30, 0		

1111111111111111111111111111111111111111111
1111100000000000000000000000000002000002001
1000000000000000000000000000000000002000001
1000111111111111111111111111111111111111111
10001000000000010000000001111111111100N0111
1000100000000001000000000111111111110000111
1000100000000001000000000000001111110000111
1000100000000001000000000000000001110000111  
1000100000000001000000000000000000000000111
1000100000000000000000000000000000000000111
1000111111111111111111111111111111110000111
1000111111111111111111111111111111110000111
1000000000000000000000000000000000000000111
1000000000000000000000000000000000000001111
1111111111111111111111111111111111111111111
