R	4000   5200
NO ./textures/mossy.xpm
SO ./textures/redbrick.xpm
EA ./textures/stone.xpm
WE ./textures/wood.xpm
S ./textures/barrel.xpm

F 255, 0, 255
C 0, 128, 128

    11111111111111111111111111111111111
11111111111111111111111111111111111111111111
1111100000000000000000000000000002000002001
1W00000000000000000000000000000000002000001
1000111111111111111111111111111111111111111
10001000000000010000000001111111111100001111
1000100000000001000000000111111111110000111
1000100000000001000000000000001111110000111
1000100000000001000000000000000001110000111
1000100000000001000000000000000000000000111
1000100000000000000000000000000000000000111111
1000111111111111111111111111111111110000111
1000111111111111111111111111111111110000111
1000000000000000000000000000000000000000111
1000000000000000000000000000000000000000111
1111100011111111111111111111111111100011111
    10001                         10001 
    10201                         10001
    11111                         11111
 