R	1920   1080
NO ./textures/mossy.xpm
SO ./textures/redbrick.xpm
EA ./textures/stone.xpm
WE ./textures/wood.xpm
S ./textures/barrel.xpm

F 255, 0, 255
C 0, 128, 128

1 1 1 1 1 1 1 1 1 1 1 1 1 1 1 1 1 1 1 1 1 1 1 1 1 1 1 1 1 1 1 1 1 1 1 1 1 1 1 1 1 1 1 
1 1 1 1 1 0 0 0 0 0 0 0 0 0 0 0 0 0 0 0 0 0 0 0 0 0 0 0 0 0 0 0 0 2 0 0 0 0 0 2 0 0 1
1W00000000000000000000000000000000002000001
1000111111111111111111111111111111111111111
10001000000000010000000001111111111100001111111111
1000100000000001000000000111111111110000111
1000100000000001000000000000001111110000111
1000100000000001000000000000000001110000111
1000100000000001000000000000000000000000111
1000100000000000000000000000000000000000111
1000111111111111111111111111111111110000111
1000111111111111111111111111111111110000111
1000000000000000000000000000000000000000111
1000000000000000000000000000000000000000111
1111111111111111111111111111111111111111111

